11111111111111111111111111111111111111111111111111111111111111111111111111111111
10000000000000000000100000000000000000000000000000000000000000000000000000000001
10s0000000000000000010000000000e0000000000000000000000000000000000000000000i0001
10000000000000000000100000000000000000000000011111111111111111111111100000000001
10011111110000000000100000000000000000000000010000000000000000000000100000000001
10010000010000000000100000000000000000000000010000000000000000000000100000e00001
10010000010000000000100000000000000000000000010000000000000000000000100000000001
10010000010000000000100000000000000000000000010000000000000000000000100000000001
10010000010000000000100000000000000000000000011111111111111111111111100000000001
10010000010000000000100000000000000000000000000000000000000000000000000000000001
10010000010000000000100000011111111110000000000000000000000000000000000000000001
10010000010000000000100000010000000010000000000000000000000000000000000000000001
10010000010000000000100000010000000010000000000000000000e00000000000000000000001
10011111110000000000100000010000000010000000000000000000000000000000000000000001
10000000000000000000100000010000000010000000000111111111000000000000000000000001
10000e00000000000000100000010000000010000000000100000001000000000000000000000001
10000000000000000000100000010000000010000000000100000001000000000000000000000001
10000000000000000000100000010000000010000000000100000001000000000000000000000001
1000000000i000000000100000010000000010000000000100000001000000000000000000000001
10000000000000000000100000010000000010000000000100000001000000000000000000000001
10000000000000000000100000010000000010000000000100000001000000000000000000000001
10000000000000000000000000011111111110000000000100000001000000000000000000000001
1000000000000000000000e000000000000000000000000100000001000000000000000000000001
10000000000000000000000000000000000000000000000111111111000000000000000000000001
10000000000000000000111111111111111111111111111111111111111111111111111111000011
10000000000000000000100000000000000000000000000000000000000000000000000000000001
10000000000000000000100000i0000000000000000000000000000000e000000000000000000001
10000111111111000000100000000000000000000000000000000000000000000000000000000001
10000100000001000000100000000111111111111111111111111111111111111111111000000001
10000100000001000000100000000100000000000000000000000000000000000000001000000001
10000100000001000000100000000100000000000000000000000000000000000000001000000001
10000100000001000000100000000100000000000000000000000000000000000000001000000001
10000100000001000000100000000100000000000000000000000000000000000000001000000001
10e00100000001000000100000000100000000000000000000000000000000000000001000000001
10000100000001000000100000000100000000000000000000000000000000000000001000000001
10000100000001000000100000000111111111111111111111111111111111111111111000000001
10000100000001000000100000000000000000000000000000000000000000000000000000000001
10000100000001000000100000000000000000001000000000000000000000000000000000000001
100001000000010000001000000000000000000000000111111110000000000000000000000e0001
10000111111111000000100000000000000000000000010000001000000000000000000000000001
1000000000000000000010000000000000e000000000010000001000000000000000000000000001
100000000000e0000000100000000000000000000000011111111000000000000000000000000001
100000000000000000001000000000000000000000e0000000000000000000000000000000000001
10000000000000000000100000000000000000000000000000000000000000000000000000000001
111111111111111111111ff111111111111111111111111111111111111111111111111111111111