11111111111111111111111111111111111111111111111111111111111111111111111111111111
10000000000000000000000000000000000000000000000000000000000000000000000000000001
10s00000000000000e00000000000000000000000000000000000000000000000000000000000001
10000000000000000000000000000000000000000000000000000000000000000000000000000001
10000000000000000000000000000000000000000000000000000000000000000000000000000001
10000000000000000000000000000000000000000000000000000000000000000000000000000001
11111111111111111111111111111111111111111111111111111111111111111111000000000011
11100000000000000000000000000000000000000000000000000000000000000000000000000001
11100000000000000000000000000000000000000000e00000000000000000000000000000000001
11100000000000000000000000000000000000000000000000000000000000000000000000000001
111000000000000000000000000000000000000000000000000000000000000i0000000000000001
11100000000e00000000000000000000000000000000000000000000000000000000000000e00001
11100000000000000000000000000000000000000000000000000000000000000000000000000001
11100000000011111111111111111111111111111111111111111111111111111111100000000001
11100000000010000000000000000000000000000000000000000000000000000000100000000001
11100000000010000000000000000000000000000000000000000000000000000000100000000001
11100000000010000000000000000000000000000000000000000000000000000000100000000001
11100000000010000000000000000000000000000000000000000000000000000000100000000001
11100000000010000000000000000000000000000000000000000000000000000000100000000001
11100000000010000000000000000000000000000000000000000000000000000000100000000001
11100000000010000000000000000000000000000000000000000000000000000000100000000001
11100000000010000000000000000000000000000000000000000000000000000000100000000001
11100000000010000000000000000000000000000000000000000000000000000000100000000001
11100000000010000000000000000000000000000000000000000000000000000000100000000001
11100000000011111111111111111111111111111111111111111111111111111111100000000001
11100000000000000000000000000000000000000000000000000000000000000000000000000001
111000i000000000000000000000000000000000000000000e000000000000000000000000000001
11100000000000000000000000000000000000000000000000000000000000000000000000000001
11100000001111111111111111111111111111111111111111111111111111111111111111111111
10000000000000000000000000000000000000000000000000000000000000000000000000000001
10000000000000000000000000000000000000000000000e00000000000000000000000000000001
10e00000000000000000000000000000000000000000000000000000000000000000000000000001
10000000000011111111111111111111111111111111111111111111111111111111100000000001
10000000000010000000000000000000000000000000000000000000000000000000100000000001
10000000000010000000000000000000000000000000000000000000000000000000100000000001
10000000000010000000000000000000000000000000000000000000000000000000100000000001
10000000000010000000000000000000000000000000000000000000000000000000100000000001
10000000000010000000000000000000000000000000000000000000000000000000100000000001
10000000000010000000000000000000000000000000000000000000000000000000100000000001
10000000000010000000000000000000000000000000000000000000000000000000100000000001
10000000000011111111111111111111111111111111111111111111111111111111100000000001
10000000000000000000000000000000000000000000000000000000000000000000000000000001
100000000000000e000000000000000000000000000000000000000000000000000000000000000f
1000000000000000000000000000000000000000000000000000000000000000000000000000000f
11111111111111111111111111111111111111111111111111111111111111111111111111111111