11111111111111111111111111111111111111111111111111111111111111111111111111111111
10000000000000001000000000000000000000000000000000000000000000000000000000000001
10s000000000000010e0000000000000000000000000000000000000000000000000000000000001
1000000000000000100000000000000000000000000000000000000000000000000000000i000001
10000000000000001000000000000000000000000000000000000000000000000000000000000001
10000000000000001000000000000000000000000000000000000000000000000000000000000001
10000000000000001000000000000000000000000000000000000000000000000000000000000001
10000000000000001000000000000000000000000000000000000000000000000000000000000001
10000000000000001000000000000000000000000000000000000000000000000000000000000001
10000000000000000000000000000000000000000000000000000000000000000000000000000001
10000000000000000000000000000000000000000000000000000000000000000000000000000001
10000000000000001000000000000000000000000000000000000000000000000000000000000e01
10000000000000001000000000000000000000000000000000000000000000000000000000000001
11111111111111111111111111111111111111111111111111000111111111111111111111111111
10000000000000000000000000000000000000000000000000000100000000000000000000000001
10000000000e0000000000000000000000000000000000000e000100000000000000000000000e01
10000000000000000000000000000000000000000000000000000100000000000000000000000001
1000000000000000000000000000000000000000000000000000010e000000000000000000000001
10000000000111111111111111111111110000000000000000000100000000000000000000000001
10000000000111111111111111111111110000000000000000000100000000000000000000000001
10000000000111111111111111111111110000000000000000000100000000000000000000000001
10000000000111111111111111111111110000000000000000000100000000000000000000000001
10000000000000000000000000000000000000000000000000000100000000000000000000000001
10000000000000000000000000000000000000000000000000000100000000000000000000000001
1e000000000000000000000000000000000000000000000000000100000000000000000i00000001
11111111100111111111111111111111111111111111111111111100000000000000000000000001
10000000000011111111111111111111111111111111111111111100000000000000000000000001
100000e0000010000000000000000000000000000000000000000000000000000000000000000001
10000000000010e0000000000000000000000000000000000000e000000000000000000000000001
10000000000010000000000000000000000000000000000000000000000000000000000000000001
10000000000010000000000000000000000000000000000000000000000000000000000000000001
10000000000010000000000000000000000000000000000000000000000000000000000000000001
10e00000000010000000000000000000000000000000000000000000000000000000000000000001
10000000000010000000000000000000000000000000000000000000000000000000000000000001
10000000000010000000000000000000000000000000000000000000000000000000000000000001
10000000000010000000000000000000000000000000000000000000000000000000000000000001
10000000000000000000000000000000000000000000000000000000000000000000000000000001
1000000000000000e000000000000000000000000000000000000000000000000000000000000001
10000000000010000000000000000000000000000000000000000000000000000000000000000001
10000000000011111111111111111111111111111100111111111111111111111111111111111111
10000000000010000000000000000000000000000000000000000000000000000000000000000001
10000000000010000000000000000000000000000000000000000000000000000000000000000001
10e00000000010000000000000000000000000000000000000000000000000000000000000000001
10000000000010000000000000000000000000000000000000000000000000000000000000000001
111111111111111111111111111111111111111111111111111111111ff111111111111111111111